"importId";"code";"parent_code";"name_fr_FR";"name_en_EN";"accountType.nameSelect";"reconcileOk";"company.id"
1;0;;"Racine PCG";"Chart of Account Root";"view";;1
2;"CL1_5";0;"Comptes de bilan";"Balance sheet accounts";"view";;1
3;"CL6_7";0;"Comptes de gestion";"Management accounts";"view";;1
4;"CL1";"CL1_5";"Comptes de capitaux";"Capital accounts";"view";;1
5;"CL2";"CL1_5";"Comptes d'immobilisations";"Property accounts";"view";;1
6;"CL3";"CL1_5";"Comptes de stocks et d'en-cours";"Inventory accounts and in-progress";"view";;1
7;"CL4";"CL1_5";"Comptes de tiers";"Third party accounts";"view";;1
8;"CL5";"CL1_5";"Comptes financiers";"Financial Accounts";"view";;1
9;"CL6";"CL6_7";"Comptes de charges";"Expense Accounts";"view";;1
10;"CL7";"CL6_7";"Comptes de produits";"Revenue Accounts";"view";;1
11;"CL8";0;"Comptes spéciaux";"Special Accounts";"view";;1
12;10;"CL1";"Capital et réserves";"Capital and reserves";"view";;1
13;101000;10;"Capital";"Capital";"equity";;1
14;101100;101000;"Capital souscrit - non appelé";"Issued capital - uncalled";"equity";;1
15;101200;101000;"Capital souscrit - appelé non versé";"Capital subscribed - called unpaid";"equity";;1
16;101300;101000;"Capital souscrit - appelé versé";"Capital subscribed - called paid";"equity";;1
17;101310;101300;"Capital non amorti";"Part-unredeemed share capital";"equity";;1
18;101320;101300;"Capital amorti";"Amortized principal/depreciated capital";"equity";;1
19;101800;101000;"Capital souscrit soumis à des réglementations particulières";"Subscribed capital subject to special regulations";"equity";;1
20;104000;10;"Primes liées au capital social";"Premiums related to capital";"equity";;1
21;104100;104000;"Primes d'émission";"Share premium";"equity";;1
22;104200;104000;"Primes de fusion";"Merger premiums";"equity";;1
23;104300;104000;"Primes d'apport";"Contribution premiums";"equity";;1
24;104400;104000;"Primes de conversion d'obligations en actions";"Premium conversion of bonds into shares";"equity";;1
25;104500;104000;"Bons de souscription d'actions";"Good Stock";"equity";;1
26;105000;10;"Écarts de réévaluation";"Revaluation";"equity";;1
27;105100;105000;"Réserve spéciale de réévaluation";"special revaluation reserve";"equity";;1
28;105200;105000;"Écart de réévaluation libre";"voluntary revaluation reserve";"equity";;1
29;105300;105000;"Réserve de réévaluation";"Revaluation reserve";"equity";;1
30;105500;105000;"Écarts de réévaluation (autres opérations légales)";" unrealized surplus from the appreciation of assets/Revaluation Surplus (other legal transactions)";"equity";;1
31;105700;105000;"Autres écarts de réévaluation en France";"Other revaluation reserves in France";"equity";;1
32;105800;105000;"Autres écarts de réévaluation à l'étranger";"Other revaluation reserves in England";"equity";;1
33;106000;10;"Réserves";"Reserves";"equity";;1
34;106100;106000;"Réserve légale";"Legal Reserves";"equity";;1
35;106110;106100;"Réserve légale proprement dite";"general statutory reserve";"equity";;1
36;106120;106100;"Plus-values nettes à long terme";" long-term capital gain ";"equity";;1
37;106200;106000;"Réserves indisponibles";"restricted reserve";"equity";;1
38;106300;106000;"Réserves statutaires ou contractuelles";"Statutory or contractual reserves";"equity";;1
39;106400;106000;"Réserves réglementées";"special regulatory reserve";"equity";;1
40;106410;106400;"Plus-values nettes à long terme";" long-term capital gain ";"equity";;1
41;106430;106400;"Réserves consécutives à l'octroi de subventions d'investissement";"Reserves resulting from the granting of investment subsidies";"equity";;1
42;106480;106400;"Autres réserves réglementées";"Other special regulatory reserve";"equity";;1
43;106800;106000;"Autres réserves";"Other Reserves";"equity";;1
44;106810;106800;"Réserve de propre assureur";"self-insurance reserve";"equity";;1
45;106880;106800;"Réserves diverses";"Various reserves";"equity";;1
46;107000;10;"Écarts d'équivalence";"equity method evaluation difference";"equity";;1
47;108000;10;"Compte de l'exploitant";"Behalf of the operator";"equity";;1
48;109000;10;"Actionnaires: capital souscrit - non appelé";"Shareholders: issued capital - uncalled";"asset";;1
49;11;"CL1";"Report à nouveau (solde créditeur ou débiteur)";"Retained earnings (credit or debit balance)";"view";;1
50;110000;11;"Report à nouveau (solde créditeur)";"Retained earnings (balance)";"equity";;1
51;119000;11;"Report à nouveau (solde débiteur)";"Retained earnings (debit balance)";"equity";;1
52;12;"CL1";"Résultat de l'exercice (bénéfice ou perte)";"Profit for the year (profit or loss)";"view";;1
53;120000;12;"Résultat de l'exercice (bénéfice)";"Profit for the year (earnings)";"equity";;1
54;129000;12;"Résultat de l'exercice (perte)";"Profit for the year (loss)";"equity";;1
55;13;"CL1";"Subventions d'investissement";"Investment subsidies";"view";;1
56;131000;13;"Subventions d'équipement";"Equipment Grants";"equity";;1
57;131100;131000;"État";"State";"equity";;1
58;131200;131000;"Régions";"Regions";"equity";;1
59;131300;131000;"Départements";"Departements";"equity";;1
60;131400;131000;"Communes";"municipalities";"equity";;1
61;131500;131000;"Collectivités publiques";"Public Sector";"equity";;1
62;131600;131000;"Entreprises publiques";"public enterprise";"equity";;1
63;131700;131000;"Entreprises et organismes privés";"Businesses and private organizations";"equity";;1
64;131800;131000;"Autres";"Other";"equity";;1
65;138000;13;"Autres subventions d'investissement (même ventilation que celle du compte 131)";"Other investment subsidies (same breakdown as Account 131)";"equity";;1
66;139000;13;"Subventions d'investissement inscrites au compte de résultat";"Investment subsidies included in the income statement";"equity";;1
67;139100;139000;"Subventions d'équipement";"Equipments Subsidiaries";"equity";;1
68;139110;139100;"Etat";"State";"equity";;1
69;139120;139100;"Régions";"Regions";"equity";;1
70;139130;139100;"Départements";"Departements";"equity";;1
71;139140;139100;"Communes";"Commons";"equity";;1
72;139150;139100;"Collectivités publiques";"Public Sector";"equity";;1
73;139160;139100;"Entreprises publiques";"public enterprise";"equity";;1
74;139170;139100;"Entreprises et organismes privés ";"Businesses and private organizations";"equity";;1
75;139180;139100;"Autres";"Other";"equity";;1
76;139800;139000;"Autres subventions d'investissement (même ventilation que celle du compte 1391)";"Other investment subsidies (same breakdown as Account 1391)";"equity";;1
77;14;"CL1";"Provisions réglementées";"Regulated provisions";"view";;1
78;142000;14;"Provisions réglementées relatives aux immobilisations";"Regulated provisions relating to fixed assets";"equity";;1
79;142300;142000;"Provisions reconstitution des gisements miniers et pétroliers";"Provisions recovery of mineral deposits and petroleum";"equity";;1
80;142400;142000;"Provisions pour investissement (participation des salariés)";"Provisions for investment (employee participation)";"equity";;1
81;143000;14;"Provisions réglementées relatives aux stocks";"Regulated provisions relating to inventories";"equity";;1
82;143100;143000;"Hausse des prix";"Rise in prices";"equity";;1
83;143200;143000;"Fluctuation des cours";"Fluctuation in prices";"equity";;1
84;144000;14;"Provisions réglementées relatives aux autres éléments de l'actif";"Regulated provisions relating to other assets";"equity";;1
85;145000;14;"Amortissements dérogatoires";"Depreciation allowances";"equity";;1
86;146000;14;"Provision spéciale de réévaluation";"Special revaluation surplus reserve";"equity";;1
87;147000;14;"Plus-values réinvesties";"Capital gains reinvested";"equity";;1
88;148000;14;"Autres provisions réglementées";"Other regulated provisions";"equity";;1
89;15;"CL1";"Provisions";"Provisions";"view";;1
90;151000;15;"Provisions pour risques";"Provisions for risks";"provision";;1
91;151100;151000;"Provisions pour litiges";"dispute and litigation reserve";"provision";;1
92;151200;151000;"Provisions pour garanties données aux clients";"Provisions for customer warranties";"provision";;1
93;151300;151000;"Provisions pour pertes sur marchés à terme";"Provision for loses in futures markets";"provision";;1
94;151400;151000;"Provisions pour amendes et pénalités";"reserve for fines and penalties";"provision";;1
95;151500;151000;"Provisions pour pertes de change";"reserve for foreign exchange losses";"provision";;1
96;151600;151000;"Provisions pour pertes sur contrats";"Provisions for losses on contracts";"provision";;1
97;151800;151000;"Autres provisions pour risques";"Other risk provisions";"provision";;1
98;153000;15;"Provisions pour pensions et obligations similaires";"Provisions for pensions and similar obligations";"provision";;1
99;154000;15;"Provisions pour restructurations";"Provisions for restructuring";"provision";;1
100;155000;15;"Provisions pour impôts";"Provisions for taxes";"provision";;1
101;156000;15;"Provisions pour renouvellement des immobilisations (entreprises concessionnaires)";"Provisions for renewal of fixed assets (concessionaires)";"provision";;1
102;157000;15;"Provisions pour charges à répartir sur plusieurs exercices";"reserve for deferred charges";"provision";;1
103;157200;157000;"Provisions pour gros entretien ou grandes révisions ";"Provisions for major repairs or major overhauls";"provision";;1
104;158000;15;"Autres provisions pour charges";"Other provisions for charges";"provision";;1
105;158100;158000;"Provisions pour remises en état";"Provision for reclamation";"provision";;1
106;16;"CL1";"Emprunts et dettes assimilées";"Debentures and similar debt";"view";;1
107;161000;16;"Emprunts obligataires convertibles";"Convertible bonds";"dettes";;1
108;163000;16;"Autres emprunts obligataires ";"Autres emprunts obligataires ";"dettes";;1
109;164000;16;"Emprunts auprès des établissements de crédit";"Other bonds";"dettes";;1
110;165000;16;"Dépôts et cautionnements reçus";"Deposits and guarantees received";"dettes";;1
111;165100;165000;"Dépôts";"Deposits";"dettes";;1
112;165500;165000;"Cautionnements";"Deposits";"dettes";;1
113;166000;16;"Participation des salariés aux résultats";"Employee profit participation";"dettes";;1
114;166100;166000;"Comptes bloqués";"Blocked accounts";"dettes";;1
115;166200;166000;"Fonds de participation";"Participation Fund";"dettes";;1
116;167000;16;"Emprunts et dettes assortis de conditions particulières";"Loans and debt Special Terms";"dettes";;1
117;167100;167000;"Emissions de titres participatifs";"Issuing equity securities";"dettes";;1
118;167400;167000;"Avances conditionnées de l'État";"Conditional advances the state";"dettes";;1
119;167500;167000;"Emprunts participatifs";"Participating loans";"dettes";;1
120;168000;16;"Autres emprunts et dettes assimilées";"Other loans and similar debts";"dettes";;1
121;168100;168000;"Autres emprunts";"Other loans";"dettes";;1
122;168500;168000;"Rentes viagères capitalisées";"Annuities capitalized";"dettes";;1
123;168700;168000;"Autres dettes";"Other liabilities";"dettes";;1
124;168800;168000;"Intérêts courus";"Accrued Interest";"dettes";;1
125;168810;168800;"Sur emprunts obligataires convertibles ";"On convertible bonds";"dettes";;1
126;168830;168800;"Sur autres emprunts obligataires";"On other bonds debenture loans";"dettes";;1
127;168840;168800;"Sur emprunts auprès des établissements de crédit";"Borrowings from credit institutions";"dettes";;1
128;168850;168800;"Sur dépôts et cautionnements reçus";"Deposits received";"dettes";;1
129;168860;168800;"Sur participation des salariés aux résultats";"On employee participation results";"dettes";;1
130;168870;168800;"Sur emprunts et dettes assortis de conditions particulières";"Borrowings on special terms";"dettes";;1
131;168880;168800;"Sur autres emprunts et dettes assimilées";"On other loans and similar debts";"dettes";;1
132;169000;16;"Primes de remboursement des obligations";"Bond redemption premiums";"dettes";;1
133;17;"CL1";"Dettes rattachées à des participations";"Liabilities to subsidiaries";"view";;1
134;171000;17;"Dettes rattachées à des participations (groupe)";"Liabilities to subsidiaries (Group)";"dettes";;1
135;174000;17;"Dettes rattachées à des participations (hors groupe)";"Debt to equity investments (excluding Group)";"dettes";;1
136;178000;17;"Dettes rattachées à des sociétés en participation";"Debts related to joint ventures";"dettes";;1
137;178100;178000;"Principal";"Main";"dettes";;1
138;178800;178000;"Intérêts courus";"Accrued Interest";"dettes";;1
139;18;"CL1";"Comptes de liaison des établissements et sociétés en participation";"Liaison accounts of institutions and ventures";"view";;1
140;181000;18;"Comptes de liaison des établissements";"Accounts Liaison institutions";"dettes";;1
141;186000;18;"Biens et prestations de services échangés entre établissements (charges)";"Goods and services exchanged between institutions (expense)";"dettes";;1
142;187000;18;"Biens et prestations de services échangés entre établissements (produits)";"Goods and services exchanged between businesses (products)";"dettes";;1
143;188000;18;"Comptes de liaison des sociétés en participation";"Accounts Liaison ventures";"dettes";;1
144;20;"CL2";"Immobilisations incorporelles";"Intangible assets";"view";;1
145;201000;20;"Frais d'établissement";"Facility Fee";"immobilization";;1
146;201100;201000;"Frais de constitution";"Formation expenses";"immobilization";;1
147;201200;201000;"Frais de premier établissement";"Start-up costs";"immobilization";;1
148;201210;201200;"Frais de prospection";"Exploration expenses";"immobilization";;1
149;201220;201200;"Frais de publicité";"Advertising costs";"immobilization";;1
150;201300;201000;"Frais d'augmentation de capital et d'opérations diverses (fusions, scissions, transformations)";"Capital increase expenses and miscellaneous transactions (mergers, conversions)";"immobilization";;1
151;203000;20;"Frais de recherche et de développement";"Costs of research and development";"immobilization";;1
152;205000;20;"Concessions et droits similaires, brevets, licences, marques, procédés, logiciels, droits et valeurs similaires";"Concessions and similar rights, patents, licenses, trademarks, processes, software, similar rights and assets";"immobilization";;1
153;206000;20;"Droit au bail";"Lease rights";"immobilization";;1
154;207000;20;"Fonds commercial";"Goodwill";"immobilization";;1
155;208000;20;"Autres immobilisations incorporelles";"Other intangible assets";"immobilization";;1
156;21;"CL2";"Immobilisations corporelles";"Tangible assets";"view";;1
157;211000;21;"Terrains";"Land";"immobilization";;1
158;211100;211000;"Terrains nus";"Unimproved";"immobilization";;1
159;211200;211000;"Terrains aménagés";"Developed land";"immobilization";;1
160;211300;211000;"Sous-sols et sur-sols";"Basements and cellars";"immobilization";;1
161;211400;211000;"Terrains de gisement";"Lots of deposit";"immobilization";;1
162;211410;211400;"Carrières";"Careers";"immobilization";;1
163;211500;211000;"Terrains bâtis";"Unimproved";"immobilization";;1
164;211510;211500;"Ensembles immobiliers industriels (A, B, ...)";"Industrial building complexes (A, B, ...)";"immobilization";;1
165;211550;211500;"Ensembles immobiliers administratifs et commerciaux (A, B, ...)";"Administrative and selling housing developments (A, B, ...)";"immobilization";;1
166;211580;211500;"Autres ensembles immobiliers";"Other housing estates";"immobilization";;1
167;211581;211580;"Affectés aux opérations professionnelles (A, B, ...)";"Allocated to business operations (A, B, ...)";"immobilization";;1
168;211588;211580;"Affectés aux opérations non professionnelles (A, B, ...)";"Assigned to non-business operations (A, B, ...)";"immobilization";;1
169;211600;211000;"Compte d'ordre sur immobilisations";"Order on capital account";"immobilization";;1
170;212000;21;"Agencements et aménagements de terrains (même ventilation que celle du compte 211)";"Fixtures and land improvements (same breakdown as the total of 211)";"immobilization";;1
171;213000;21;"Constructions";"Constructions";"immobilization";;1
172;213100;213000;"Bâtiments";"Buildings";"immobilization";;1
173;213110;213100;"Ensembles immobiliers industriels (A, B, ...)";"Industrial building complexes (A, B, ...)";"immobilization";;1
174;213150;213100;"Ensembles immobiliers administratifs et commerciaux (A, B, ...)";"Administrative and selling housing developments (A, B, ...)";"immobilization";;1
175;213180;213100;"Autres ensembles immobiliers";"Other housing estates";"immobilization";;1
176;213181;213180;"Affectés aux opérations professionnelles (A, B, ...)";"Allocated to business operations (A, B, ...)";"immobilization";;1
177;213188;213180;"Affectés aux opérations non professionnelles (A, B, ...)";"Assigned to non-business operations (A, B, ...)";"immobilization";;1
178;213500;213000;"Installations générales agencements aménagements des constructions (même ventilation que celle du compte 2131)";"General facilities, fixtures and fittings of buildings (same breakdown as Account 2131)";"immobilization";;1
179;213800;213000;"Ouvrages d'infrastructure";"Infrastructure works";"immobilization";;1
180;213810;213800;"Voies de terre";"Tract of land";"immobilization";;1
181;213820;213800;"Voies de fer";"Assault Iron";"immobilization";;1
182;213830;213800;"Voies d'eau";"Waterways";"immobilization";;1
183;213840;213800;"Barrages";"Dams";"immobilization";;1
184;213850;213800;"Pistes d'aérodromes";"Airfield runways";"immobilization";;1
185;214000;21;"Constructions sur sol d'autrui (même ventilation que celle du compte 213)";"Buildings on land of another (same breakdown as Account 213)";"immobilization";;1
186;215000;21;"Installations techniques matériels et outillages industriels";"Technical facilities equipment and tooling";"immobilization";;1
187;215100;215000;"Installations complexes spécialisées";"Specialized complex installations";"immobilization";;1
188;215110;215100;"Sur sol propre";"On own land";"immobilization";;1
189;215140;215100;"Sur sol d'autrui";"On other land";"immobilization";;1
190;215300;215000;"Installations à caractère spécifique";"Facilities to specific character";"immobilization";;1
191;215310;215300;"Sur sol propre";"On own land";"immobilization";;1
192;215340;215300;"Sur sol d'autrui";"On other land";"immobilization";;1
193;215400;215000;"Matériel industriel";"Industrial equipment";"immobilization";;1
194;215500;215000;"Outillage industriel";"Industrial Machinery";"immobilization";;1
195;215700;215000;"Agencements et aménagements du matériel et outillage industriels";"Fixtures and fittings of industrial machinery and equipment";"immobilization";;1
196;218000;21;"Autres immobilisations corporelles";"Other tangible assets";"immobilization";;1
197;218100;218000;"Installations générales agencements aménagements divers";"General facilities, fixtures and fittings various";"immobilization";;1
198;218200;218000;"Matériel de transport";"Transportation equipment";"immobilization";;1
199;218300;218000;"Matériel de bureau et matériel informatique ";"Office equipment and computer hardware";"immobilization";;1
200;218400;218000;"Mobilier";"Furniture";"immobilization";;1
201;218500;218000;"Cheptel";"Livestock";"immobilization";;1
202;218600;218000;"Emballages récupérables";"Returnable packaging";"immobilization";;1
203;22;"CL2";"Immobilisations mises en concession";"Assets in concession";"view";;1
204;23;"CL2";"Immobilisations en cours";"Assets under construction";"view";;1
205;231000;23;"Immobilisations corporelles en cours";"Assets under construction";"immobilization";;1
206;231200;231000;"Terrains";"Land";"immobilization";;1
207;231300;231000;"Constructions";"Constructions";"immobilization";;1
208;231500;231000;"Installations techniques matériel et outillage industriels";"Technical equipment industrial machinery and equipment";"immobilization";;1
209;231800;231000;"Autres immobilisations corporelles";"Other tangible assets";"immobilization";;1
210;232000;23;"Immobilisations incorporelles en cours ";"Intangible assets under";"immobilization";;1
211;237000;23;"Avances et acomptes versés sur commandes d'immobilisations incorporelles";"Advances and prepayments of intangible assets";"immobilization";;1
212;238000;23;"Avances et acomptes versés sur commandes d'immobilisations corporelles";"Advances and prepayments of fixed assets";"immobilization";;1
213;238200;238000;"Terrains";"Land";"immobilization";;1
214;238300;238000;"Constructions";"Construction";"immobilization";;1
215;238500;238000;"Installations techniques matériel et outillage industriels";"Technical equipment industrial machinery and equipment";"immobilization";;1
216;238800;238000;"Autres immobilisations corporelles";"Other tangible assets";"immobilization";;1
217;25;"CL2";"Parts dans des entreprises liées et créances dans des entreprises liées";"Shares in affiliated undertakings and amounts receivable in affiliated enterprises";"view";;1
218;26;"CL2";"Participations et créances rattachées à des participations";"Investments and advances in subsidiaries";"view";;1
219;261000;26;"Titres de participation";"Equity";"immobilization";;1
220;261100;261000;"Actions";"Actions";"immobilization";;1
221;261800;261000;"Autres titres";"Other titles";"immobilization";;1
222;262000;26;"Titres évalués par équivalence";"Investments stated at equity";"immobilization";;1
223;266000;26;"Autres formes de participation";"Forms of participation";"immobilization";;1
224;267000;26;"Créances rattachées à des participations";"Receivables from participations";"immobilization";;1
225;267100;267000;"Créances rattachées à des participations (groupe)";"Receivables from affiliates (Group)";"immobilization";;1
226;267400;267000;"Créances rattachées à des participations (hors groupe)";"Receivables from affiliates (excluding Group)";"immobilization";;1
227;267500;267000;"Versements représentatifs d'apports non capitalisés (appel de fonds)";"Payments representing unfunded contributions (fundraising)";"immobilization";;1
228;267600;267000;"Avances consolidables";"Advances's consolidating";"immobilization";;1
229;267700;267000;"Autres créances rattachées à des participations ";"Other receivables from participations";"immobilization";;1
230;267800;267000;"Intérêts courus";"Accrued Interest";"immobilization";;1
231;268000;26;"Créances rattachées à des sociétés en participation";"Receivables from joint ventures";"immobilization";;1
232;268100;268000;"Principal";"Main";"immobilization";;1
233;268800;268000;"Intérêts courus";"Accrued Interest";"immobilization";;1
234;269000;26;"Versements restant à effectuer sur titres de participation non libérés";"Payments outstanding equity securities on an undischarged";"immobilization";;1
235;27;"CL2";"Autres immobilisations financières";"Other financial assets";"view";;1
236;271000;27;"Titres immobilisés autres que les titres immobilisés de l'activité de portefeuille (droit de propriété)";"Other investments other than investment securities portfolio activity (property)";"immobilization";;1
237;271100;271000;"Actions";"Actions";"immobilization";;1
238;271800;271000;"Autres titres";"Other titles";"immobilization";;1
239;272000;27;"Titres immobilisés (droit de créance)";"Term investments (debt)";"immobilization";;1
240;272100;272000;"Obligations";"Bonds";"immobilization";;1
241;272200;272000;"Bons";"Good";"immobilization";;1
242;273000;27;"Titres immobilisés de l'activité de portefeuille (TIAP)";"Investment securities portfolio activity (portfolio investments)";"immobilization";;1
243;274000;27;"Prêts";"Loans";"immobilization";;1
244;274100;274000;"Prêts participatifs";"Equity loans";"immobilization";;1
245;274200;274000;"Prêts aux associés";"Loans to associates";"immobilization";;1
246;274300;274000;"Prêts au personnel";"Staff loans";"immobilization";;1
247;274800;274000;"Autres prêts";"Other loans";"immobilization";;1
248;275000;27;"Dépôts et cautionnements versés";"Deposits and guarantees paid";"immobilization";;1
249;275100;275000;"Dépôts";"Deposits";"immobilization";;1
250;275500;275000;"Cautionnements";"Deposits";"immobilization";;1
251;276000;27;"Autres créances immobilisées";"Other long term receivables";"immobilization";;1
252;276100;276000;"Créances diverses";"Other receivables";"immobilization";;1
253;276800;276000;"Intérêts courus";"Accrued Interest";"immobilization";;1
254;276820;276800;"Sur titres immobilisés (droits de créance)";"On investment securities (debt)";"immobilization";;1
255;276840;276800;"Sur prêts";"Loan";"immobilization";;1
256;276850;276800;"Sur dépôts et cautionnements";"On deposits and bonds";"immobilization";;1
257;276880;276800;"Sur créances diverses";"Various credit";"immobilization";;1
258;277000;27;"Actions propres ou parts propres";"Own shares or own shares";"immobilization";;1
259;277100;277000;"Actions propres ou parts propres";"Own shares or own shares";"immobilization";;1
260;277200;277000;"Actions propres ou parts propres en voie d'annulation";"Own shares or own shares in the cancellation";"immobilization";;1
261;279000;27;"Versements restant à effectuer sur titres immobilisés non libérés";"Payments outstanding on an undischarged term investments";"immobilization";;1
262;28;"CL2";"Amortissement des immobilisations";"Amortization of capital assets";"view";;1
263;280000;28;"Amortissements des immobilisations incorporelles";"Amortization of intangible assets";"immobilization";;1
264;280100;280000;"Frais d'établissement (même ventilation que celle du compte 201) ";"Expenses (same breakdown as the account 201)";"immobilization";;1
265;280300;280000;"Frais de recherche et de développement ";"Costs of research and development";"immobilization";;1
266;280500;280000;"Concessions et droits similaires, brevets, licences, logiciels, droits et valeurs similaires";"Concessions and similar rights, patents, licenses, software, similar rights and assets";"immobilization";;1
267;280700;280000;"Fonds commercial";"Goodwill";"immobilization";;1
268;280800;280000;"Autres immobilisations incorporelles";"Other intangible assets";"immobilization";;1
269;281000;28;"Amortissements des immobilisations corporelles";"Depreciation of fixed assets";"immobilization";;1
270;281100;281000;"Terrains de gisement";"Lots of deposit";"immobilization";;1
271;281200;281000;"Agencements aménagements de terrains (même ventilation que celle du compte 212)";"Fixtures and fittings of land (same breakdown as the account 212)";"immobilization";;1
272;281300;281000;"Constructions (même ventilation que celle du compte 213)";"Structures (same breakdown as the account 213)";"immobilization";;1
273;281400;281000;"Constructions sur sol d'autrui (même ventilation que celle du compte 214)";"Buildings on land of another (same breakdown as Account 214)";"immobilization";;1
274;281500;281000;"Installations matériel et outillage industriels (même ventilation que celle du compte 215)";"Industrial machinery and equipment installations (same breakdown as Account 215)";"immobilization";;1
275;281800;281000;"Autres immobilisations corporelles (même ventilation que celle du compte 218)";"Other intangible assets (same breakdown as the account 218)";"immobilization";;1
276;282000;28;"Amortissements des immobilisations mises en concession";"Depreciation of fixed assets in concession";"immobilization";;1
277;29;"CL2";"Dépréciation des immobilisations";"Impairment of assets";"view";;1
278;290000;29;"Dépréciations des immobilisations incorporelles";"Impairment of intangible assets";"immobilization";;1
279;290500;290000;"Marques, procédés, droits et valeurs similaires";"Marks, processes, rights and similar values";"immobilization";;1
280;290600;290000;"Droit au bail";"Lease rights";"immobilization";;1
281;290700;290000;"Fonds commercial";"Goodwill";"immobilization";;1
282;290800;290000;"Autres immobilisations incorporelles";"Other intangible assets";"immobilization";;1
283;291000;29;"Dépréciations des immobilisations corporelles (même ventilation que celle du compte 21)";"Impairment of fixed assets (same breakdown as the account 21)";"immobilization";;1
284;291100;291000;"Terrains (autres que terrains de gisement)";"Land (other than land of deposit)";"immobilization";;1
285;292000;29;"Dépréciations des immobilisations mises en concession";"Impairment of fixed assets in concession";"immobilization";;1
286;293000;29;"Dépréciations des immobilisations en cours";"Impairment of assets under";"immobilization";;1
287;293100;293000;"Immobilisations corporelles en cours";"Assets under construction";"immobilization";;1
288;293200;293000;"Immobilisations incorporelles en cours";"Intangible assets under";"immobilization";;1
289;296000;29;"Provisions pour dépréciation des participations et créances rattachées à des participations";"Impairment of investments and advances to subsidiaries";"immobilization";;1
290;296100;296000;"Titres de participation";"Equity";"immobilization";;1
291;296600;296000;"Autres formes de participation";"Forms of participation";"immobilization";;1
292;296700;296000;"Créances rattachées à des participations (même ventilation que celle du compte 267)";"Receivables from affiliates (same breakdown as the 267)";"immobilization";;1
293;296800;296000;"Créances rattachées à des sociétés en participation (même ventilation que celle du compte 268)";"Receivables from associated companies (same breakdown as Account 268)";"immobilization";;1
294;297000;29;"Dépréciations des autres immobilisations financières";"Impairment of other investments";"immobilization";;1
295;297100;297000;"Titres immobilisés autres que les titres immobilisés de l'activité de portefeuille - droit de propriété (ventilation : 271)";"Other investments other than investment securities portfolio of activity - property rights (breakdown: 271)";"immobilization";;1
296;297200;297000;"Titres immobilisés - droit de créance (même ventilation que celle du compte 272) ";"Investment securities - debt securities (same breakdown as Account 272)";"immobilization";;1
297;297300;297000;"Titres immobilisés de l'activité de portefeuille";"Investment securities portfolio activity";"immobilization";;1
298;297400;297000;"Prêts (même ventilation que celle du compte 274)";"Loans (same breakdown as Account 274)";"immobilization";;1
299;297500;297000;"Dépôts et cautionnements versés (même ventilation que celle du compte 275)";"Deposits and guarantees paid (same breakdown as the account 275)";"immobilization";;1
300;297600;297000;"Autres créances immobilisées (même ventilation que celle du compte 276)";"Other long term receivables (same breakdown as Account 276)";"immobilization";;1
301;31;"CL3";"Matières premières (et fourniture)";"Raw materials (and delivery)";"view";;1
302;311000;31;"Matière (ou groupe) A";"Material (or group) A";"current asset";;1
303;312000;31;"Matière (ou groupe) B";"Material (or group) B";"current asset";;1
304;317000;31;"Fournitures A, B, C, ..";"Supplies A, B, C, ..";"current asset";;1
305;32;"CL3";"Autres approvisionnements";"Other supplies";"view";;1
306;321000;32;"Matières consommables";"Consumables";"current asset";;1
307;321100;321000;"Matière (ou groupe) C";"Material (or group) C";"current asset";;1
308;321200;321000;"Matière (ou groupe) D";"Material (or group) D";"current asset";;1
309;322000;32;"Fournitures consommables";"Consumables";"current asset";;1
310;322100;322000;"Combustibles";"Fuels";"current asset";;1
311;322200;322000;"Produits d'entretien";"Cleaning Products";"current asset";;1
312;322300;322000;"Fournitures d'atelier et d usine";"Shop Supplies and plant";"current asset";;1
313;322400;322000;"Fournitures de magasin";"Store supplies";"current asset";;1
314;322500;322000;"Fournitures de bureau";"Office Supplies";"current asset";;1
315;326000;32;"Emballages";"Packaging";"current asset";;1
316;326100;326000;"Emballages perdus";"Packaging waste";"current asset";;1
317;326500;326000;"Emballages récupérables non identifiables";"Returnable packaging unidentifiable";"current asset";;1
318;326700;326000;"Emballages à usage mixte";"Mixed-use packaging";"current asset";;1
319;33;"CL3";"En-cours de production de biens";"In-process goods";"view";;1
320;331000;33;"Produits en cours";"Products in";"current asset";;1
321;331100;331000;"Produit en cours P 1";"Product in P 1";"current asset";;1
322;331200;331000;"Produit en cours P 2";"Product in P 2";"current asset";;1
323;335000;33;"Travaux en cours";"Work in progress";"current asset";;1
324;335100;335000;"Travaux en cours T 1";"Work in Progress T 1";"current asset";;1
325;335200;335000;"Travaux en cours T 2";"Work in Progress T 2";"current asset";;1
326;34;"CL3";"En-cours de production de services";"In-process services";"view";;1
327;341000;34;"Études en cours";"Ongoing Studies";"current asset";;1
328;341100;341000;"Études en cours E 1";"Ongoing Studies E 1";"current asset";;1
329;341200;341000;"Études en cours E 2";"Ongoing studies E 2";"current asset";;1
330;345000;34;"Prestations de services en cours";"Services being";"current asset";;1
331;345100;345000;"Prestations de services S 1";"Services S 1";"current asset";;1
332;345200;345000;"Prestations de services S 2";"Services S 2";"current asset";;1
333;35;"CL3";"Stocks de produits";"Product Stocks";"view";;1
334;351000;35;"Produits intermédiaires";"Intermediates";"current asset";;1
335;351100;351000;"Produits intermédiaires (ou groupe) A ";"Intermediate products (or group) A";"current asset";;1
336;351200;351000;"Produits intermédiaires (ou groupe) B";"Intermediate products (or group) B";"current asset";;1
337;355000;35;"Produits finis";"Finished Products";"current asset";;1
338;355100;355000;"Produits finis (ou groupe) A";"Finished goods (or group) A";"current asset";;1
339;355200;355000;"Produits finis (ou groupe) B";"Finished goods (or group) B";"current asset";;1
340;358000;35;"Produits résiduels (ou matières de récupération)";"Residual products (or material recovery)";"current asset";;1
341;358100;358000;"Déchets";"Waste";"current asset";;1
342;358500;358000;"Rebuts";"Garbage";"current asset";;1
343;358600;358000;"Matières de récupération";"Materials recovery";"current asset";;1
344;36;"CL3";"Stocks provenant d'immobilisations";"Stocks from capital";"view";;1
345;37;"CL3";"Stocks de marchandises";"Merchandise inventories";"view";;1
346;371000;37;"Marchandises (ou groupe) A";"Goods (or group) A";"current asset";;1
347;372000;37;"Marchandises (ou groupe) B";"Goods (or group) B";"current asset";;1
348;38;"CL3";"Stocks en voie d'acheminement";"Inventory en route";"view";;1
349;39;"CL3";"Provisions pour dépréciation des stocks et en-cours";"Impairment of inventory and WIP";"view";;1
350;391000;39;"Provisions pour dépréciation des matières premières (et fournitures)";"Impairment of raw materials (supplies)";"current asset";;1
351;391100;391000;"Matières (ou groupe) A";"Subjects (or group) A";"current asset";;1
352;391200;391000;"Matières (ou groupe) B";"Material (or group) B";"current asset";;1
353;391700;391000;"Fournitures A, B, C, ..";"Supplies A, B, C, ..";"current asset";;1
354;392000;39;"Provisions pour dépréciation des autres approvisionnements";"Impairment of other supplies";"current asset";;1
355;392100;392000;"Matières consommables (même ventilation que celle du compte 321)";"Consumables (same breakdown as the account 321)";"current asset";;1
356;392200;392000;"Fournitures consommables (même ventilation que celle du compte 322)";"Consumables (same breakdown as the account 322)";"current asset";;1
357;392600;392000;"Emballages (même ventilation que celle du compte 326)";"Packaging (same breakdown as the account 326)";"current asset";;1
358;393000;39;"Provisions pour dépréciation des en-cours de production de biens";"Impairment of in-process goods";"current asset";;1
359;393100;393000;"Produits en cours (même ventilation que celle du compte 331)";"Products in (same breakdown as Account 331)";"current asset";;1
360;393500;393000;"Travaux en cours (même ventilation que celle du compte 335)";"Work in progress (same breakdown as the account 335)";"current asset";;1
361;394000;39;"Provisions pour dépréciation des en-cours de production de services";"Impairment of in-process services";"current asset";;1
362;394100;394000;"Études en cours (même ventilation que celle du compte 341)";"Ongoing studies (same breakdown as the account 341)";"current asset";;1
363;394500;394000;"Prestations de services en cours (même ventilation que celle du compte 345)";"Services in progress (same breakdown as Account 345)";"current asset";;1
364;395000;39;"Provisions pour dépréciation des stocks de produits";"Impairment of inventories of";"current asset";;1
365;395100;395000;"Produits intermédiaires (même ventilation que celle du compte 351)";"Intermediate products (same breakdown as the account 351)";"current asset";;1
366;395500;395000;"Produits finis (même ventilation que celle du compte 355)";"Finished goods (same breakdown as the account 355)";"current asset";;1
367;397000;39;"Provisions pour dépréciation des stocks de marchandises";"Provisions for depreciation of stocks of goods";"current asset";;1
368;397100;397000;"Marchandises (ou groupe) A";"Goods (or group) A";"current asset";;1
369;397200;397000;"Marchandises (ou groupe) B";"Goods (or group) B";"current asset";;1
370;40;"CL4";"Fournisseurs et comptes rattachés";"Trade accounts payable";"view";;1
371;400000;40;"Fournisseurs et comptes rattachés ";"Trade accounts payable";"payable";"true";1
372;401;40;"Fournisseurs";"Suppliers";"payable";;1
373;401100;401000;"Fournisseurs - Achats de biens et prestations de services";"Suppliers - Purchases of goods and services";"payable";"true";1
374;401700;401000;"Fournisseurs - Retenues de garantie";"Suppliers - Holdbacks";"payable";"true";1
375;403000;40;"Fournisseurs - Effets à payer";"Payable - Notes Payable";"payable";"true";1
376;404000;40;"Fournisseurs d'immobilisations";"Fixed asset suppliers";"payable";"true";1
377;404100;404000;"Fournisseurs - Achats d'immobilisations";"Suppliers - Purchases of capital assets";"payable";"true";1
378;404700;404000;"Fournisseurs d'immobilisations - Retenues de garantie";"Suppliers of capital - Holdbacks";"payable";"true";1
379;405000;40;"Fournisseurs d'immobilisations - Effets à payer";"Suppliers of capital - Notes Payable";"payable";"true";1
380;408000;40;"Fournisseurs - Factures non parvenues";"Suppliers - Invoices not received";"payable";"true";1
381;408100;408000;"Fournisseurs";"Suppliers";"payable";"true";1
382;408400;408000;"Fournisseurs d'immobilisations ";"Fixed asset suppliers";"payable";"true";1
383;408800;408000;"Fournisseurs - Intérêts courus";"Suppliers - Accrued interest";"payable";"true";1
384;409;40;"Fournisseurs débiteurs";"Receivables from suppliers";"payable";;1
385;409100;409000;"Fournisseurs - Avances et acomptes versés sur commandes";"Suppliers - Advances and prepayments";"current asset";"true";1
386;409600;409000;"Fournisseurs - Créances pour emballages et matériel à rendre";"Suppliers - Claims for packaging and equipment to make";"current asset";"true";1
387;409700;409000;"Fournisseurs - Autres avoirs";"Suppliers - Other assets";"current asset";"true";1
388;409710;409700;"Fournisseurs d'exploitation";"Providers operating";"current asset";"true";1
389;409740;409700;"Fournisseurs d'immobilisations";"Fixed asset suppliers";"current asset";"true";1
390;409800;409000;"Rabais, remises, ristournes à obtenir et autres avoirs non encore reçus";"Discounts, rebates, discounts available and other assets not yet received";"current asset";"true";1
391;41;"CL4";"Clients et comptes rattachés";"Accounts receivable";"view";;1
392;410000;41;"Clients et comptes rattachés ";"Accounts receivable";"receivable";"true";1
393;411;41;"Clients";"Customer";"receivable";;1
394;411100;411000;"Clients - Ventes de biens ou de prestations de services";"Customers - Sales of goods or services";"receivable";"true";1
395;411700;411000;"Clients - Retenues de garantie";"Customer - Holdbacks";"receivable";"true";1
396;413000;41;"Clients - Effets à recevoir";"Customers - Accounts Receivable";"receivable";;1
397;416000;41;"Clients douteux ou litigieux";"Doubtful or disputed";"receivable";"true";1
398;418000;41;"Clients - Produits non encore facturés";"Customers - unbilled";"receivable";"true";1
399;418100;418000;"Clients - Factures à établir ";"Customer - Unbilled";"receivable";"true";1
400;418800;418000;"Clients - Intérêts courus";"Customer - Accrued interest";"receivable";"true";1
401;419000;41;"Clients créditeurs";"Customer prepayments";"receivable";;1
402;419100;419000;"Clients - Avances et acomptes reçus sur commandes";"Customer - Advances received on orders";"dettes";"true";1
403;419600;419000;"Clients - Dettes pour emballages et matériels consignés ";"Customer - Debts for returnable packaging and material";"dettes";"true";1
404;419700;419000;"Clients - Autres avoirs ";"Customer - Other assets";"dettes";"true";1
405;419800;419000;"Rabais, remises, ristournes à accorder et autres avoirs à établir";"Rebates, discounts, rebates and other funds to grant to establish";"dettes";"true";1
406;42;"CL4";"Personnel et comptes rattachés";"Personnel and related accounts";"view";;1
407;421000;42;"Personnel - Rémunérations dues";"Personnel - Compensation due";"dettes";;1
408;422000;42;"Comités d'entreprise d'établissement ";"Works of establishment";"dettes";;1
409;424000;42;"Participation des salariés aux résultats";"Employee profit participation";"dettes";;1
410;424600;424000;"Réserve spéciale";"Special reserve";"dettes";;1
411;424800;424000;"Comptes courants";"Current accounts";"dettes";;1
412;425000;42;"Personnel - Avances et acomptes";"People – Advances and prepayment";"receivable";;1
413;426000;42;"Personnel - Dépôts";"Staff - Deposits";"dettes";;1
414;427000;42;"Personnel - Oppositions";"Staff - Objections";"dettes";;1
415;428000;42;"Personnel - Charges à payer et produits à recevoir";"Staff - Accounts payable and accruals";"dettes";;1
416;428200;428000;"Dettes provisionnées pour congés à payer";"Accrued liabilities for vacation pay";"dettes";;1
417;428400;428000;"Dettes provisionnées pour participation des salariés aux résultats";"Debts accrued for employee profit sharing results";"dettes";;1
418;428600;428000;"Autres charges à payer";"Other accrued liabilities";"dettes";;1
419;428700;428000;"Produits à recevoir";"Accrued income";"receivable";;1
420;43;"CL4";"Sécurité Sociale et autres organismes sociaux";"Social Security and other social agencies";"view";;1
421;431000;43;"Sécurité Sociale";"Social Security";"dettes";;1
422;437000;43;"Autres organismes sociaux";"Other social agencies";"dettes";;1
423;438000;43;"Organismes sociaux - Charges à payer et produits à recevoir";"Social organizations - Accrued expenses and accrued income";"dettes";;1
424;438200;438000;"Charges sociales sur congés à payer ";"Payroll tax on holiday pay";"dettes";;1
425;438600;438000;"Autres charges à payer";"Other accrued liabilities";"dettes";;1
426;438700;438000;"Produits à recevoir";"Accrued income";"receivable";;1
427;44;"CL4";"Etat et autres collectivités publiques";"State and other public";"view";;1
428;441000;44;"État - Subventions à recevoir";"State - Grants receivable";"receivable";;1
429;441100;441000;"Subventions d'investissement";"Investment subsidies";"receivable";;1
430;441700;441000;"Subventions d'exploitation";"Operating subsidies";"receivable";;1
431;441800;441000;"Subventions d'équilibre";"Matching grants";"receivable";;1
432;441900;441000;"Avances sur subventions";"Advances on grants";"receivable";;1
433;442000;44;"État -Impôts et taxes recouvrables sur des tiers ";"State-Taxes recoverable from third parties";"tax";;1
434;442400;442000;"Obligataires";"Bond";"tax";;1
435;442500;442000;"Associés";"Related";"tax";;1
436;443000;44;"Opérations particulières avec l'État, les collectivités publiques, les organismes internationaux";"Special operations with the State, public authorities, international agencies";"tax";;1
437;443100;443000;"Créances sur l'État résultant de la suppression de la règle du décalage d'un mois en matière de TVA";"Sovereign debt resulting from the elimination of the rule of one-month delay in VAT";"receivable";;1
438;443800;443000;"Intérêts courus sur créances figurant au compte 4431";"Accrued interest on debt on the accounts 4431";"tax";;1
439;444000;44;"État - Impôts sur les bénéfices";"State - Income taxes";"tax";;1
440;445000;44;"État - Taxes sur le chiffre d'affaires";"State - Taxes on turnover";"tax";;1
441;445200;445000;"TVA due intracommunautaire";"Intra-Community VAT payable";"tax";;1
442;445201;445000;"TVA due intracommunautaire 19.6%";"Intra-Community VAT payable 19.6%";"tax";;1
443;445202;445000;"TVA due intracommunautaire 5.5%";"Intra-Community VAT payable 5.5%";"tax";;1
444;445203;445000;"TVA due intracommunautaire (autre taux)";"current accounts";"tax";;1
445;445500;445000;"Taxes sur le chiffre d'affaires à décaisser";"People - Advances";"tax";;1
446;445510;445500;"TVA à décaisser";"VAT to be disbursed";"tax";;1
447;445511;445510;"TVA N à décaisser 19.6%";"VAT N to be disbursed (19.6%)";"tax";;1
448;445512;445510;"TVA R1 à décaisser 7%";"VAT R1 to be disbursed (7%)";"tax";;1
449;445513;445510;"TVA R2 à décaisser 5.5%";"VAT R2 to be disbursed (5.5%)";"tax";;1
450;445514;445510;"TVA décaissée (autre taux : U...)";"VAT to be disbursed (other rate : U...)";"tax";;1
451;445580;445500;"Taxes assimilées à la TVA";"Similar taxes to VAT";"tax";;1
452;445600;445000;"Taxes sur le chiffre d'affaires déductibles";"Taxes on turnover deductible";"tax";;1
453;445620;445600;"TVA sur immobilisations";"VAT on fixed assets";"tax";;1
454;445630;445600;"TVA transférée par d'autres entreprises";"VAT transferred by other companies";"tax";;1
455;445660;445600;"TVA sur autres biens et services";"VAT on other goods and services";"tax";;1
456;445662;445600;"TVA déductible intracommunautaire";"Intra-deductible VAT";"tax";;1
457;445670;445600;"Crédit de TVA à reporter";"VAT credit to postpone";"tax";;1
458;445680;445600;"Taxes assimilées à la TVA";"Similar taxes to VAT";"tax";;1
459;445700;445000;"Taxes sur le chiffre d'affaires collectées par l'entreprise";"Tax revenues collected by the company";"tax";;1
460;445710;445700;"TVA collectée";"VAT collected";"tax";;1
461;445711;445710;"TVA N collectée 19.6%";"VAT N collected 19.6%";"tax";;1
462;445712;445710;"TVA R1 collectée 7 %";"VAT R1 collected 7%";"tax";;1
463;445713;445710;"TVA R2 collectée 5.5%";"VAT R2 collected 5.5%";"tax";;1
464;445714;445710;"TVA collectée (autre taux : U...)";"VAT collection (other rate : U …)";"tax";;1
465;445780;445700;"Taxes assimilées à la TVA";"Similar taxes to VAT";"tax";;1
466;445800;445000;"Taxes sur le chiffre d'affaires à régulariser ou en attente";"Taxes on turnover to regulate or pending";"tax";;1
467;445810;445800;"Acomptes - Régime simplifié d'imposition";"Installments - Simplified tax";"tax";;1
468;445820;445800;"Acomptes - Régime du forfait";"Installments - Package Plan";"tax";;1
469;445830;445800;"Remboursement de taxes sur le chiffre d'affaires demandé";"Reimbursement of taxes on turnover requested";"tax";;1
470;445840;445800;"TVA récupérée d'avance";"VAT recovered in advance";"tax";;1
471;445860;445800;"Taxes sur le chiffre d'affaires sur factures non parvenues";"Taxes on sales invoices not received";"tax";;1
472;445870;445800;"Taxes sur le chiffre d'affaires sur factures à établir";"Taxes on sales invoices to determine";"tax";;1
473;446000;44;"Obligations cautionnées";"Secured bonds";"tax";;1
474;447000;44;"Autres impôts, taxes et versements assimilés";"Other taxes, fees and similar payments";"tax";;1
475;448000;44;"État - Charges à payer et produits à recevoir";"State - Accrued expenses and accrued income";"tax";;1
476;448200;448000;"Charges fiscales sur congés à payer ";"Tax burden on holiday pay";"tax";;1
477;448600;448000;"Charges à payer";"Accruals";"tax";;1
478;448700;448000;"Produits à recevoir";"Accrued income";"tax";;1
479;449000;44;"Quotas d'émission à restituer à l'État";"Emission allowances to be returned to the State";"tax";;1
480;45;"CL4";"Groupe et associés";"Group and associates";"view";;1
481;451000;45;"Groupe";"Group";"receivable";;1
482;455000;45;"Associés - Comptes courants";"Associates - Current Account";"receivable";;1
483;455100;455000;"Principal";"Main";"receivable";;1
484;455800;455000;"Intérêts courus";"Accrued Interest";"receivable";;1
485;456000;45;"Associés - Opérations sur le capital";"Associate - Capital transactions";"receivable";;1
486;456100;456000;"Associés - Comptes d'apport en société";"Associate - Accounts contribution in society";"receivable";;1
487;456110;456100;"Apports en nature";"Contributions in kind";"receivable";;1
488;456150;456100;"Apports en numéraire";"Cash contributions";"receivable";;1
489;456200;456000;"Apporteurs - Capital appelé, non versé";"Contributors - Called up capital, unpaid";"receivable";;1
490;456210;456200;"Actionnaires - Capital souscrit et appelé, non versé";"Shareholders - Capital subscribed and called, unpaid";"receivable";;1
491;456250;456200;"Associés - Capital appelé, non versé";"Associates - Called up capital, unpaid";"receivable";;1
492;456300;456000;"Associés - Versements reçus sur augmentation de capital";"Associates - Payments received on capital increase";"receivable";;1
493;456400;456000;"Associés - Versements anticipés";"Associates - Advance payments";"receivable";;1
494;456600;456000;"Actionnaires défaillants";"Shareholders failed";"receivable";;1
495;456700;456000;"Associés - Capital à rembourser";"Associate - Capital repayment";"receivable";;1
496;457000;45;"Associés - Dividendes à payer";"Shareholders - Dividends payable";"dettes";;1
497;458000;45;"Associés - Opérations faites en commun et en GIE";"Associates - joint ventures and GIE";"receivable";;1
498;458100;458000;"Opérations courantes";"Current Operations";"receivable";;1
499;458800;458000;"Intérêts courus";"Accrued Interest";"receivable";;1
500;46;"CL4";"Débiteurs divers et créditeurs divers";"Sundry debtors and sundry creditors";"view";;1
501;462000;46;"Créances sur cessions d'immobilisations";"Receivables from sale of property";"receivable";;1
502;464000;46;"Dettes sur acquisitions de valeurs mobilières de placement";"Debt related to acquisition of investment securities";"dettes";;1
503;465000;46;"Créances sur cessions de valeurs mobilières de placement";"Receivables from sales of marketable securities";"receivable";;1
504;467000;46;"Autres comptes débiteurs ou créditeurs";"Other accounts receivable or payable";"view";;1
505;468000;46;"Divers - Charges à payer et produits à recevoir";"Miscellaneous - Accrued expenses and accrued income";"receivable";;1
506;468600;468000;"Charges à payer";"Accruals";"dettes";;1
507;468700;468000;"Produits à recevoir";"Accrued income";"receivable";;1
508;47;"CL4";"Comptes transitoires ou d'attente";"Prepayments or waiting";"view";;1
509;471000;47;"Comptes d'attente 1";"Suspense Accounts 1";"receivable";;1
510;472000;47;"Comptes d'attente 2";"Suspense accounts 2";"receivable";;1
511;473000;47;"Comptes d'attente 3";"Suspense accounts 3";"receivable";;1
512;474000;47;"Comptes d'attente 4";"Suspense accounts 4";"receivable";;1
513;475000;47;"Comptes d'attente 5";"Suspense accounts 5";"receivable";;1
514;476000;47;"Différences de conversion - ACTIF";"Translation differences - ASSETS";"receivable";;1
515;476100;476000;"Diminution des créances";"Decrease in receivables";"receivable";;1
516;476200;476000;"Augmentation des dettes";"Increase in payables";"receivable";;1
517;476800;476000;"Différences compensées par couverture de change";"Differences offset by hedging";"receivable";;1
518;477000;47;"Différences de conversion - PASSIF";"Translation differences - Liabilities";"dettes";;1
519;477100;477000;"Augmentation des créances";"Increase in receivables";"dettes";;1
520;477200;477000;"Diminution des dettes";"Decrease in debt";"dettes";;1
521;477800;477000;"Différences compensées par couverture de change";"Differences offset by hedging";"dettes";;1
522;478000;47;"Autres comptes transitoires";"Other transitory accounts";"view";;1
523;48;"CL4";"Comptes de régularisation";"Accruals";"view";;1
524;481000;48;"Charges à répartir sur plusieurs exercices ";"Accrued Deferred";"receivable";;1
525;481600;481000;"Frais d'émission des emprunts";"Issue costs of borrowings";"receivable";;1
526;486000;48;"Charges constatées d'avance";"Prepaid expenses";"receivable";;1
527;487000;48;"Produits constatés d'avance";"Deferred income";"dettes";;1
528;488000;48;"Comptes de répartition périodique des charges et des produits";"Accounts of periodic distribution of income and expense";"view";;1
529;488600;488000;"Charges";"Charges";"dettes";;1
530;488700;488000;"Produits";"Products";"receivable";;1
531;489000;48;"Quotas d'émission alloués par l'État";"Emission allowances allocated by the State";"receivable";;1
532;49;"CL4";"Dépréciations des comptes de tiers";"Impairment of accounts of others";"view";;1
533;491000;49;"Dépréciation des comptes de clients";"Impairment of client accounts";"dettes";;1
534;495000;49;"Dépréciation des comptes du groupe et des associés";"Depreciation of the group and associates";"dettes";;1
535;495100;495000;"Comptes du groupe";"Group accounts";"dettes";;1
536;495500;495000;"Comptes courants des associés";"Current accounts of shareholders";"dettes";;1
537;495800;495000;"Opérations faites en commun et en GIE";"Joint ventures and GIE";"dettes";;1
538;496000;49;"Dépréciations des comptes de débiteurs divers";"Impairment of sundry debtors";"receivable";;1
539;496200;496000;"Créances sur cessions d'immobilisations";"Receivables from sale of property";"receivable";;1
540;496500;496000;"Créances sur cessions de valeurs mobilières de placement";"Receivables from sales of marketable securities";"receivable";;1
541;496700;496000;"Autres comptes débiteurs";"Other accounts receivable";"receivable";;1
542;50;"CL5";"Valeurs mobilières de placement";"Marketable securities";"view";;1
543;501000;50;"Parts dans entreprises liées";"Shares in affiliated companies";"cash";;1
544;502000;50;"Actions propres";"Treasury shares";"cash";;1
545;503000;50;"Actions";"Actions";"cash";;1
546;503100;503000;"Titres cotés";"Listed securities";"cash";;1
547;503500;503000;"Titres non cotés";"Unlisted";"cash";;1
548;504000;50;"Autres titres conférant un droit de propriété";"Other securities conferring the right of ownership";"cash";;1
549;505000;50;"Obligations et bons émis par la société et rachetés par elle";"Bonds and notes issued by the company and purchased by it";"cash";;1
550;506000;50;"Obligations";"Bonds";"cash";;1
551;506100;506000;"Titres cotés";"Listed securities";"cash";;1
552;506500;506000;"Titres non cotés";"Unlisted";"cash";;1
553;507000;50;"Bons du Trésor et bons de caisse à court terme";"Treasury bills and certificates of deposit in the short term";"cash";;1
554;508000;50;"Autres valeurs mobilières de placement et autres créances assimilées";"Other marketable securities and other similar debts";"cash";;1
555;508100;508000;"Autres valeurs mobilières";"Other securities";"cash";;1
556;508200;508000;"Bons de souscription";"Warrants";"cash";;1
557;508800;508000;"Intérêts courus sur obligations, bons et valeurs assimilées";"Accrued interest on bonds, bills and similar securities";"cash";;1
558;509000;50;"Versements restant à effectuer sur valeurs mobilières de placement non libérées";"Payments outstanding on marketable securities uncleared";"cash";;1
559;51;"CL5";"Banques établissements financiers et assimilés";"Banks and similar financial institutions";"view";;1
560;511000;51;"Valeurs à l'encaissement";"Items for collection";"cash";;1
561;511100;511000;"Coupons échus à l'encaissement";"Coupons due for collection";"cash";;1
562;511200;511000;"Chèques à encaisser";"Cheque cashing";"cash";;1
563;511300;511000;"Effets à l'encaissement";"Collection items";"cash";;1
564;511400;511000;"Effets à l'escompte";"Bills discounting";"cash";;1
565;511500;511000;"CB encaissées";"Credit card cashed";"cash";;1
566;512;51;"Banques";"Banks";"cash";;1
567;512100;512000;"Comptes en monnaie nationale";"Accounts in national currency";"cash";;1
568;512400;512000;"Comptes en devises";"Currency Accounts";"cash";;1
569;514000;51;"Chèques postaux";"Giro";"cash";;1
570;515000;51;"Caisses du Trésor et des établissements publics";"Treasury funds and public institutions";"cash";;1
571;516000;51;"Sociétés de bourse";"Brokerage firms";"cash";;1
572;517000;51;"Autres organismes financiers";"Other financial institutions";"cash";;1
573;518000;51;"Intérêts courus";"Accrued Interest";"cash";;1
574;518100;518000;"Intérêts courus à payer";"Accrued interest payable";"cash";;1
575;518800;518000;"Intérêts courus à recevoir";"Accrued interest receivable";"cash";;1
576;519000;51;"Concours bancaires courants";"Bank overdrafts";"cash";;1
577;519100;519000;"Crédit de mobilisation de créances commerciales (CMCC)";"Credit mobilization of commercial debt (CMCC)";"cash";;1
578;519300;519000;"Mobilisation de créances nées à l'étranger";"Mobilization of claims arising abroad";"cash";;1
579;519800;519000;"Intérêts courus sur concours bancaires courants";"Accrued interest on bank overdrafts";"cash";;1
580;52;"CL5";"Instruments de trésorerie";"Cash instruments";"view";;1
581;53;"CL5";"Caisse";"Fund";"view";;1
582;531000;53;"Caisse siège social";"Box office";"cash";;1
583;531100;531000;"Caisse en monnaie nationale";"Cash in national currency";"cash";;1
584;531400;531000;"Caisse en devises";"Fund currency";"cash";;1
585;532000;53;"Caisse succursale (ou usine) A";"Fund branch (or factory) A";"cash";;1
586;533000;53;"Caisse succursale (ou usine) B";"Fund branch (or factory) B";"cash";;1
587;54;"CL5";"Régies d'avances et accréditifs";"Imprest accounts and credentials";"view";;1
588;58;"CL5";"Virements internes";"Internal transfers";"view";;1
589;580100;;"Virements internes";"Internal transfers";"cash";;1
590;580200;;"Différence de caisse";"Cashier closure differences";"cash";;1
591;580300;;"Ecarts de règlement";"Payment variances";"cash";;1
592;59;"CL5";"Provisions pour dépréciation des comptes financiers";"Impairment of financial accounts";"view";;1
593;590000;59;"Provisions pour dépréciation des valeurs mobilières de placement";"Impairment of marketable securities";"cash";;1
594;590300;59;"Actions";"Actions";"cash";;1
595;590400;59;"Autres titres conférant un droit de propriété ";"Other securities conferring the right of ownership";"cash";;1
596;590600;59;"Obligations";"Bonds";"cash";;1
597;590800;59;"Autres valeurs mobilières de placement et créances assimilées (provisions)";"Other investment securities and related receivables (provisions)";"cash";;1
598;60;"CL6";"Achats(sauf 603)";"Purchases (except 603)";"view";;1
599;601000;60;"Achats stockés - Matières premières (et fournitures)";"Stored purchases - Raw (and supplies)";"expense";;1
600;601100;601000;"Matières (ou groupe) A";"Subjects (or group) A";"expense";;1
601;601200;601000;"Matières (ou groupe) B";"Material (or group) B";"expense";;1
602;601700;601000;"Fournitures A, B, C, ..";"Supplies A, B, C, ..";"expense";;1
603;602000;60;"Achats stockés - Autres approvisionnements";"Stored purchases - Other supplies";"expense";;1
604;602100;602000;"Matières consommables";"Consumables";"expense";;1
605;602110;602100;"Matières (ou groupe) C";"Material (or group) C";"expense";;1
606;602120;602100;"Matières (ou groupe) D";"Material (or group) D";"expense";;1
607;602200;602000;"Fournitures consommables";"Consumables";"expense";;1
608;602210;602200;"Combustibles";"Fuels";"expense";;1
609;602220;602200;"Produits d'entretien";"Cleaning Products";"expense";;1
610;602230;602200;"Fournitures d'atelier et d'usine";"Shop Supplies and factory";"expense";;1
611;602240;602200;"Fournitures de magasin";"Store supplies";"expense";;1
612;602250;602200;"Fournitures de bureau";"Office Supplies";"expense";;1
613;602600;602000;"Emballages";"Packaging";"expense";;1
614;602610;602600;"Emballages perdus";"Packaging waste";"expense";;1
615;602650;602600;"Emballages récupérables non identifiables";"Returnable packaging unidentifiable";"expense";;1
616;602670;602600;"Emballages à usage mixte";"Mixed-use packaging";"expense";;1
617;603000;60;"Variation des stocks (approvisionnements et marchandises)";"Changes in inventories (supplies and goods)";"expense";;1
618;603100;603000;"Variation des stocks de matières premières (et fournitures)";"Changes in inventories of raw materials (supplies)";"expense";;1
619;603200;603000;"Variation des stocks des autres approvisionnements";"Change in stocks of other supplies";"expense";;1
620;603700;603000;"Variation des stocks de marchandises";"Changes in inventories of goods";"expense";;1
621;604000;60;"Achats d'études et prestations de services";"Purchases of studies and services";"expense";;1
622;605000;60;"Achats de matériel équipements et travaux";"Purchases of equipment and work equipment";"expense";;1
623;606000;60;"Achats non stockés de matières et fournitures";"Non stored purchases of materials and supplies";"expense";;1
624;606100;606000;"Fournitures non stockables (eau, énergie...) ";"Non-storable supplies (water, energy ...)";"expense";;1
625;606300;606000;"Fournitures d'entretien et de petit équipement";"Maintenance supplies and small equipment";"expense";;1
626;606400;606000;"Fournitures administratives";"Administrative supplies";"expense";;1
627;606800;606000;"Autres matières et fournitures";"Other materials and supplies";"expense";;1
628;607000;60;"Achats de marchandises";"Purchases of goods";"expense";;1
629;607100;607000;"Marchandise (ou groupe) A";"Commodity (or group) A";"expense";;1
630;607200;607000;"Marchandise (ou groupe) B";"Commodity (or group) B";"expense";;1
631;608000;60;"Frais accessoires incorporés aux achats";"Incidentals included purchases";"expense";;1
632;609000;60;"Rabais, remises et ristournes obtenus sur achats";"Discounts, rebates and discounts available on purchases";"expense";;1
633;609100;609000;"- de matières premières (et fournitures)";"- raw materials (supplies)";"expense";;1
634;609200;609000;"- d'autres approvisionnements stockés";"- other supplies stored";"expense";;1
635;609400;609000;"- d'études et prestations de services";"- studies and services";"expense";;1
636;609500;609000;"- de matériel, équipements et travaux";"- materials, equipment and work";"expense";;1
637;609600;609000;"- d'approvisionnements non stockés";"- non-stock supplies";"expense";;1
638;609700;609000;"- de marchandises";"- Merchandise";"expense";;1
639;609800;609000;"Rabais, remises et ristournes non affectés";"Rebates, discounts and rebates Unrestricted";"expense";;1
640;61;"CL6";"Services extérieurs";"Outdoor Services";"view";;1
641;611000;61;"Sous-traitance générale";"Subcontracting";"expense";;1
642;612000;61;"Redevances de crédit-bail";"Leasing charges";"expense";;1
643;612200;612000;"Crédit-bail mobilier";"Equipment leasing";"expense";;1
644;612500;612000;"Crédit-bail immobilier";"Property leasing";"expense";;1
645;613000;61;"Locations";"Rentals";"expense";;1
646;613200;613000;"Locations immobilières";"Property rentals";"expense";;1
647;613500;613000;"Locations mobilières";"Real estate rentals";"expense";;1
648;613600;613000;"Malis sur emballages";"Malis on packaging";"expense";;1
649;614000;61;"Charges locatives et de copropriété";"Charges and condominium";"expense";;1
650;615000;61;"Entretien et réparations";"Maintenance and repairs";"expense";;1
651;615200;615000;"- sur biens immobiliers";"- on property";"expense";;1
652;615500;615000;"- sur biens mobiliers";"- on movable";"expense";;1
653;615600;615000;"Maintenance";"Maintenance";"expense";;1
654;616000;61;"Primes d'assurance";"Insurance Premiums";"expense";;1
655;616100;616000;"Multirisques";"Casualty";"expense";;1
656;616200;616000;"Assurance obligatoire dommage construction ";"Compulsory insurance building damage";"expense";;1
657;616300;616000;"Assurance transport";"Transportation Insurance";"expense";;1
658;616360;616300;"Assurance transport sur achats";"Transport insurance on purchases";"expense";;1
659;616370;616300;"Assurance transportsur ventes";"Transportsur insurance sales";"expense";;1
660;616380;616300;"Assurance transport sur autres biens";"Transport insurance on other property";"expense";;1
661;616400;616000;"Risques d'exploitation";"Operating Risks";"expense";;1
662;616500;616000;"Insolvabilité clients";"Insolvent customers";"expense";;1
663;617000;61;"Études et recherches";"Research and Studies";"expense";;1
664;618000;61;"Divers";"Miscellaneous";"expense";;1
665;618100;618000;"Documentation générale";"General Documentation";"expense";;1
666;618300;618000;"Documentation technique";"Technical Documentation";"expense";;1
667;618500;618000;"Frais de colloques, séminaires, conférences";"Expenses of conferences, seminars, conferences";"expense";;1
668;619000;61;"Rabais, remises et ristournes obtenus sur services extérieurs";"Discounts, rebates and discounts on services obtained outside";"expense";;1
669;62;"CL6";"Autres services extérieurs";"Other external services";"view";;1
670;621000;62;"Personnel extérieur à l'entreprise";"Personnel from outside the company";"expense";;1
671;621100;621000;"Personnel intérimaire";"Temporary Staff";"expense";;1
672;621400;621000;"Personnel détaché ou prêté à l'entreprise";"Staff seconded or loaned to the company";"expense";;1
673;622000;62;"Rémunérations d'intermédiaires et honoraires ";"Intermediary fees and fees";"expense";;1
674;622100;622000;"Commissions et courtages sur achats ";"And brokerage commissions on purchases";"expense";;1
675;622200;622000;"Commissions et courtages sur ventes";"Commission and brokerage on sales";"expense";;1
676;622400;622000;"Rémunérations des transitaires";"Remuneration Freight";"expense";;1
677;622500;622000;"Rémunérations d'affacturage";"Factoring Compensation";"expense";;1
678;622600;622000;"Honoraires";"Fees";"expense";;1
679;622700;622000;"Frais d'actes et de contentieux";"Legal fees and litigation";"expense";;1
680;622800;622000;"Divers";"Miscellaneous";"expense";;1
681;623000;62;"Publicité, publications, relations publiques";"Advertising, publishing, public relations";"expense";;1
682;623100;623000;"Annonces et insertions";"Ads and inserts";"expense";;1
683;623200;623000;"Échantillons";"Samples";"expense";;1
684;623300;623000;"Foires et expositions";"Fairs and exhibitions";"expense";;1
685;623400;623000;"Cadeaux à la clientèle";"Gifts to clients";"expense";;1
686;623500;623000;"Primes";"Rewards";"expense";;1
687;623600;623000;"Catalogues et imprimés";"Catalogues and";"expense";;1
688;623700;623000;"Publications";"Publications";"expense";;1
689;623800;623000;"Divers (pourboires, dons courants...)";"Miscellaneous (tips, current grants ...)";"expense";;1
690;624000;62;"Transports de biens et transports collectifs du personnel";"Transport of goods and transport staff";"expense";;1
691;624100;624000;"Transports sur achats";"Transport on purchases";"expense";;1
692;624200;624000;"Transports sur ventes";"Transport on sales";"expense";;1
693;624300;624000;"Transports entre établissements ou chantiers";"Transport between facilities or sites";"expense";;1
694;624400;624000;"Transports administratifs";"Transportation Administrative";"expense";;1
695;624700;624000;"Transports collectifs du personnel";"Transport staff";"expense";;1
696;624800;624000;"Divers";"Miscellaneous";"expense";;1
697;625000;62;"Déplacements missions et réceptions";"Travel missions and receptions";"expense";;1
698;625100;625000;"Voyages et déplacements";"Travel and transport";"expense";;1
699;625500;625000;"Frais de déménagement";"Removal expenses";"expense";;1
700;625600;625000;"Missions";"Missions";"expense";;1
701;625700;625000;"Réceptions";"Receptions";"expense";;1
702;626000;62;"Frais postaux et frais de télécommunications";"Postage and telecommunication costs";"expense";;1
703;627000;62;"Services bancaires et assimilés";"Banking and related";"expense";;1
704;627100;627000;"Frais sur titres (achat, vente, garde)";"Fees on securities (purchase, sale, custody)";"expense";;1
705;627200;627000;"Commissions et frais sur émission d'emprunts";"Commissions and fees on debt issuance";"expense";;1
706;627500;627000;"Frais sur effets";"Charge effects";"expense";;1
707;627600;627000;"Location de coffres";"Safe custody";"expense";;1
708;627800;627000;"Autres frais et commissions sur prestations de services";"Other fees and commissions on services";"expense";;1
709;628000;62;"Divers";"Miscellaneous";"expense";;1
710;628100;628000;"Concours divers (cotisations...)";"Various competitions (cotisations...)";"expense";;1
711;628400;628000;"Frais de recrutement de personnel";"Staff recruitment costs";"expense";;1
712;629000;62;"Rabais, remises et ristournes obtenus sur autres services extérieurs";"Discounts, rebates and discounts on other services obtained outside";"expense";;1
713;63;"CL6";"Impôts, taxes et versements assimilés";"Taxes and similar payments";"view";;1
714;631000;63;"Impôts, taxes et versements assimilés sur rémunérations (administration des impôts)";"Taxes on salaries and related payments (Tax Administration)";"expense";;1
715;631100;631000;"Taxe sur les salaires";"Payroll tax";"expense";;1
716;631200;631000;"Taxe d'apprentissage";"Apprenticeship tax";"expense";;1
717;631300;631000;"Participation des employeurs à la formation professionnelle continue";"Employer participation in continuing vocational training";"expense";;1
718;631400;631000;"Cotisation pour défaut d'investissement obligatoire dans la construction";"Fee for non-mandatory investment in construction";"expense";;1
719;631800;631000;"Autres";"Other";"expense";;1
720;633000;63;"Impôts, taxes et versements assimilés sur rémunérations (autres organismes)";"Taxes on salaries and related payments (other agencies)";"expense";;1
721;633100;633000;"Versement de transport";"Transport tax";"expense";;1
722;633200;633000;"Allocation logement";"Housing benefit";"expense";;1
723;633300;633000;"Participation des employeurs à la formation professionnelle continue";"Employer participation in continuing vocational training";"expense";;1
724;633400;633000;"Participation des employeurs à l'effort de construction";"Employer participation in the construction effort";"expense";;1
725;633500;633000;"Versements libératoires ouvrant droit à l'exonération de la taxe d'apprentissage";"Release calls entitlement to tax exemption learning";"expense";;1
726;633800;633000;"Autres";"Other";"expense";;1
727;635000;63;"Autres impôts, taxes et versements assimilés (administration des impôts)";"Other taxes, fees and similar payments (Tax Administration)";"expense";;1
728;635100;635000;"Impôts directs (sauf impôts sur les bénéfices)";"Direct taxes (except income taxes)";"expense";;1
729;635110;635100;"Taxe professionnelle";"Business Tax";"expense";;1
730;635120;635100;"Taxes foncières";"Property Taxes";"expense";;1
731;635130;635100;"Autres impôts locaux";"Other local taxes";"expense";;1
732;635140;635100;"Taxe sur les véhicules des sociétés";"Tax on company vehicles";"expense";;1
733;635200;635000;"Taxes sur le chiffre d'affaires non récupérables ";"Taxes on turnover not recoverable";"expense";;1
734;635300;635000;"Impôts indirects";"Indirect taxes";"expense";;1
735;635400;635000;"Droits d'enregistrement et de timbre";"Registration fees and stamp duty";"expense";;1
736;635410;635400;"Droits de mutation";"Transfer taxes";"expense";;1
737;635800;635000;"Autres droits";"Other rights";"expense";;1
738;637000;63;"Autres impôts, taxes et versements assimilés (autres organismes)";"Other taxes, fees and similar payments (other agencies)";"expense";;1
739;637100;637000;"Contribution sociale de solidarité à la charge des sociétés";"Social solidarity contribution levied on companies to";"expense";;1
740;637200;637000;"Taxes perçues par les organismes publics internationaux";"Fees charged by public international bodies";"expense";;1
741;637400;637000;"Impôts et taxes exigibles à l'étranger";"Taxes due from abroad";"expense";;1
742;637800;637000;"Taxes diverses";"Miscellaneous taxes";"expense";;1
743;64;"CL6";"Charges de personnel";"Personnel expenses";"view";;1
744;641000;64;"Rémunérations du personnel";"Staff salaries";"expense";;1
745;641100;641000;"Salaires et appointements";"Wages and salaries";"expense";;1
746;641200;641000;"Congés payés";"Paid vacation";"expense";;1
747;641300;641000;"Primes et gratifications";"Bonuses and gratuities";"expense";;1
748;641400;641000;"Indemnités et avantages divers";"Fringe benefits";"expense";;1
749;641500;641000;"Supplément familial";"FS";"expense";;1
750;644000;64;"Rémunération du travail de l'exploitant";"Remuneration for work of the operator";"expense";;1
751;645;64;"Charges de Sécurité sociale et de prévoyance";"Burdens of Social Security and Welfare";"expense";;1
752;645100;645000;"Cotisations à l'URSSAF";"Contributions to URSSAF";"expense";;1
753;645200;645000;"Cotisations aux mutuelles";"Contributions to mutual";"expense";;1
754;645300;645000;"Cotisations aux caisses de retraites";"Contributions to pension funds";"expense";;1
755;645400;645000;"Cotisations aux ASSEDIC";"Contributions to ASSEDIC";"expense";;1
756;645800;645000;"Cotisations aux autres organismes sociaux";"Contributions to other social agencies";"expense";;1
757;646;64;"Cotisations sociales personnelles de l'exploitant";"Personal social security contributions of the operator";"expense";;1
758;647000;64;"Autres charges sociales";"Other social charges";"expense";;1
759;647100;647000;"Prestations directes";"Direct benefits";"expense";;1
760;647200;647000;"Versements aux comités d'entreprise et d'établissement";"Payments to councils and school";"expense";;1
761;647300;647000;"Versements aux comités d'hygiène et de sécurité";"Payments to health committees and safety";"expense";;1
762;647400;647000;"Versements aux autres oeuvres sociales";"Payments to other social works";"expense";;1
763;647500;647000;"Médecine du travail pharmacie";"Occupational medicine";"expense";;1
764;648000;64;"Autres charges de personnel";"Other personnel expenses";"expense";;1
765;65;"CL6";"Autres charges de gestion courante";"Other current operating expenses";"view";;1
766;651000;65;"Redevances pour concessions, brevets, licences, marques, procédés, logiciels, droits et valeurs similaires";"Fees for concessions, patents, licenses, trademarks, processes, software, similar rights and assets";"expense";;1
767;651100;651000;"Redevances pour concessions brevets, licences, marques, procédés, logiciels ";"Patent Fees for concessions, licenses, trademarks, processes, software";"expense";;1
768;651600;651000;"Droits d'auteur et de reproduction";"Copyright and reproduction";"expense";;1
769;651800;651000;"Autres droits et valeurs similaires";"Other similar rights and assets";"expense";;1
770;653000;65;"Jetons de présence";"Attendance";"expense";;1
771;654000;65;"Pertes sur créances irrécouvrables";"Losses on bad debts";"expense";;1
772;654100;654000;"Créances de l'exercice";"Receivables for the year";"expense";;1
773;654400;654000;"Créances des exercices antérieurs";"Prior years'claims";"expense";;1
774;655000;65;"Quotes-parts de résultat sur opérations faites en commun";"Assessed on income from joint ventures";"expense";;1
775;655100;655000;"Quote-part de bénéfice transférée (comptabilité du gérant)";"Share of profit transferred (Accounting Manager)";"expense";;1
776;655500;655000;"Quote-part de perte supportée (comptabilité des associés non gérants)";"Share of loss incurred (accounts of shareholders who are not managers)";"expense";;1
777;658000;65;"Charges diverses de gestion courante";"Various routine administrative expenses";"expense";;1
778;66;"CL6";"Charges financières";"Financial charges";"view";;1
779;661000;66;"Charges d'intérêt";"Interest expense";"expense";;1
780;661100;661000;"Intérêts des emprunts et dettes";"Interest on loans and debts";"expense";;1
781;661160;661100;"Intérêts des emprunts et dettes assimilées";"Interest on loans and similar debts";"expense";;1
782;661170;661100;"Intérêts des dettes rattachées à des participations";"Interest on debt related to investments";"expense";;1
783;661500;661000;"Intérêts des comptes courants et des dépôts créditeurs";"Interest on current accounts and deposits payable";"expense";;1
784;661600;661000;"Intérêts bancaires et sur opérations de financement (escompte, ...)";"Bank interest and financing activities (discount, ...)";"expense";;1
785;661700;661000;"Intérêts des obligations cautionnées";"Interests of secured bonds";"expense";;1
786;661800;661000;"Intérêts des autres dettes";"Interests of other debts";"expense";;1
787;661810;661800;"Intérêts des dettes commerciales";"Interests in trade payables";"expense";;1
788;661880;661800;"Intérêts des dettes diverses";"Interests of various debt";"expense";;1
789;664000;66;"Pertes sur créances liées à des participations";"Credit losses associated with investments";"expense";;1
790;665000;66;"Escomptes accordés";"Discounts granted";"expense";;1
791;666000;66;"Pertes de change";"Exchange losses";"expense";;1
792;667000;66;"Charges nettes sur cessions de valeurs mobilières de placement";"Net losses on sales of marketable securities";"expense";;1
793;668000;66;"Autres charges financières";"Other financial charges";"expense";;1
794;67;"CL6";"Charges exceptionnelles";"Extraordinary expenses";"view";;1
795;671000;67;"Charges exceptionnelles sur opérations de gestion";"Extraordinary expenses on management operations";"expense";;1
796;671100;671000;"Pénalités sur marchés (et dédits payés sur achats et ventes)";"Penalties on markets (and forfeits paid on purchases and sales)";"expense";;1
797;671200;671000;"Pénalités, amendes fiscales et pénales ";"Penalties, fines and criminal tax";"expense";;1
798;671300;671000;"Dons, libéralités";"Donations,gifts";"expense";;1
799;671400;671000;"Créances devenues irrécouvrables dans l'exercice";"Receivables become uncollectible in the year";"expense";;1
800;671500;671000;"Subventions accordées";"Subsidies";"expense";;1
801;671700;671000;"Rappels d'impôts (autres qu'impôts sur les bénéfices)";"Reminders of taxes (other than taxes on profits)";"expense";;1
802;671800;671000;"Autres charges exceptionnelles sur opération de gestion";"Other extraordinary charges on transaction management";"expense";;1
803;672000;67;"Charges sur exercices antérieurs (en cours d'exercice seulement)";"Prior period expenses (in-year only)";"expense";;1
804;675000;67;"Valeurs comptables des éléments d'actif cédés";"Carrying values of assets transferred";"expense";;1
805;675100;675000;"Immobilisations incorporelles";"Intangible assets";"expense";;1
806;675200;675000;"Immobilisations corporelles";"Tangible assets";"expense";;1
807;675600;675000;"Immobilisations financières";"Financial assets";"expense";;1
808;675800;675000;"Autres éléments d'actif";"Other assets";"expense";;1
809;678000;67;"Autres charges exceptionnelles";"Other extraordinary charges";"expense";;1
810;678100;678000;"Malis provenant de clauses d'indexation ";"Malis from indexation clauses";"expense";;1
811;678200;678000;"Lots";"Lots";"expense";;1
812;678300;678000;"Malis provenant du rachat par l'entreprise d'actions et obligations émises par elle-même";"Malis from the repurchase by the Company of shares and bonds issued by itself";"expense";;1
813;678800;678000;"Charges exceptionnelles diverses";"Various exceptional charges";"expense";;1
814;68;"CL6";"Dotations aux amortissements, dépréciations et provisions";"Depreciation, amortization and provisions";"view";;1
815;681000;68;"Dotations aux amortissements, dépréciations et provisions - Charges d'exploitation, Amortisation, depreciation and provisions - Operating expenses";"expense";;"AXG";
816;681100;681000;"Dotations aux amortissements des immobilisations incorporelles et corporelles ";"Amortisation of intangible and tangible";"expense";;1
817;681110;681100;"Immobilisations incorporelles";"Intangible assets";"expense";;1
818;681120;681100;"Immobilisations corporelles";"Tangible assets";"expense";;1
819;681200;681000;"Dotations aux amortissements des charges d'exploitation à répartir";"Amortisation of operating expenses to be apportioned";"expense";;1
820;681500;681000;"Dotations aux provisions pour risques et charges d'exploitation";"Provisions for risks and expenses";"expense";;1
821;681600;681000;"Dotations pour dépréciations des immobilisations incorporelles et corporelles";"Allowances for impairment of intangible and tangible";"expense";;1
822;681610;681600;"Immobilisations incorporelles";"Intangible assets";"expense";;1
823;681620;681600;"Immobilisations corporelles";"Tangible assets";"expense";;1
824;681700;681000;"Dotations aux provisions pour dépréciation des actifs circulants";"Provisions for impairment of assets";"expense";;1
825;681730;681700;"Stocks et en-cours";"Stocks and work in progress";"expense";;1
826;681740;681700;"Créances";"Claims";"expense";;1
827;686000;68;"Dotations aux amortissements, dépréciations et provisions - Charges financières";"Amortisation, depreciation and provisions - financial charges";"expense";;1
828;686100;686000;"Dotations aux amortissements des primes de remboursement des obligations";"Amortisation of premium on redemption of bonds";"expense";;1
829;686500;686000;"Dotations aux provisions pour risques et charges financiers";"Provisions for risks and expenses";"expense";;1
830;686600;686000;"Dotations aux dépréciation des éléments financiers";"Depreciation and impairment of financial items";"expense";;1
831;686620;686600;"Immobilisations financières";"Financial assets";"expense";;1
832;686650;686600;"Valeurs mobilières de placement";"Marketable securities";"expense";;1
833;686800;686000;"Autres dotations";"Other allocations";"expense";;1
834;687000;68;"Dotations aux amortissements, dépréciations et provisions - Charges exceptionnelles";"Amortisation, depreciation and provisions - Extraordinary expenses";"expense";;1
835;687100;687000;"Dotations aux amortissements exceptionnels des immobilisations";"Depreciation of fixed assets outstanding";"expense";;1
836;687200;687000;"Dotations aux provisions réglementées (immobilisations)";"Regulated provisions (capital)";"expense";;1
837;687250;687200;"Amortissements dérogatoires";"Depreciation allowances";"expense";;1
838;687300;687000;"Dotations aux provisions réglementées (stocks)";"Regulated provisions (stocks)";"expense";;1
839;687400;687000;"Dotations aux autres provisions réglementées";"Depreciation and other regulatory provisions";"expense";;1
840;687500;687000;"Dotations aux provisions exceptionnelles";"Depreciation and exceptional items";"expense";;1
841;687600;687000;"Dotations aux dépréciations exceptionnelles";"Depreciation and impairment losses";"expense";;1
842;69;"CL6";"Participation des salariés - Impôts sur les bénéfices et assimilés";"Employee participation - income taxes and related";"view";;1
843;691000;69;"Participation des salariés aux résultats";"Employee profit participation";"expense";;1
844;695000;69;"Impôts sur les bénéfices";"Income taxes";"expense";;1
845;695100;695000;"Impôts dus en France";"Taxes due in France";"expense";;1
846;695200;695000;"Contribution additionnelle à l'impôt sur les bénéfices";"Additional contribution to profits tax";"expense";;1
847;695400;695000;"Impôts dus à l'étranger";"Taxes due to foreign";"expense";;1
848;696000;69;"Supplément d'impôt sur les sociétés lié aux distributions";"Additional tax on companies related to distributions";"expense";;1
849;697000;69;"Imposition forfaitaire annuelle des sociétés";"Fixed annual tax of companies";"expense";;1
850;698000;69;"Intégration fiscale";"Tax consolidation";"expense";;1
851;698100;698000;"Intégration fiscale - Charges";"Tax consolidation - Expenses";"expense";;1
852;698900;698000;"Intégration fiscale - Produits";"Tax consolidation - Products";"expense";;1
853;699000;69;"Produits, Reports en arrière des déficits";"Products, carry back losses";"expense";;1
854;70;"CL7";"Ventes de produits fabriqués - Prestations de service - Marchandises";"Produced sales - Services - Merchandise";"view";;1
855;701000;70;"Ventes de produits finis";"Sales of finished products";"income";;1
856;701200;701000;"Produits finis (ou groupe) B";"Finished goods (or group) B";"income";;1
857;702000;70;"Ventes de produits intermédiaires";"Sales of intermediate products";"income";;1
858;703000;70;"Ventes de produits résiduels";"Sales of residual products";"income";;1
859;704000;70;"Travaux";"Works";"income";;1
860;704100;704000;"Travaux de catégorie (ou activité) A";"Class work (or activity) A";"income";;1
861;704200;704000;"Travaux de catégorie (ou activité) B";"Class work (or activity) B";"income";;1
862;705000;70;"Études";"Studies";"income";;1
863;706000;70;"Prestations de services";"Services";"income";;1
864;707000;70;"Ventes de marchandises";"Merchandise Sales";"income";;1
865;707100;707000;"Marchandises (ou groupe) A";"Goods (or group) A";"income";;1
866;707200;707000;"Marchandises (ou groupe) B";"Goods (or group) B";"income";;1
867;707210;707200;"Ventes de produits textiles";"Sales of textile product";"income";;1
868;707300;707000;"Marchandises à l'exportation";"Goods for export";"income";;1
869;708000;70;"Produits des activités annexes";"Revenue from auxiliary activities";"income";;1
870;708100;708000;"Produits des services exploités dans l'intérêt du personnel";"Income from services operated in the interests of staff";"income";;1
871;708200;708000;"Commissions et courtages";"Commission and brokerage";"income";;1
872;708300;708000;"Locations diverses";"Various rentals";"income";;1
873;708400;708000;"Mise à disposition de personnel facturée ";"Provision of staff charged";"income";;1
874;708500;708000;"Ports et frais accessoires facturés";"Transportation and incidental costs charged";"income";;1
875;708600;708000;"Bonis sur reprises d'emballages consignés";"Bonus on occasions of returnable packaging";"income";;1
876;708700;708000;"Bonifications obtenues des clients et primes sur ventes";"Bonuses and premiums obtained from customers on sales";"income";;1
877;708800;708000;"Autres produits d'activités annexes (cessions d'approvisionnements...)";"Other products activities (sales of supplies ...)";"income";;1
878;709000;70;"Rabais, remises et ristournes accordés par l'entreprise";"Discounts, rebates and discounts granted by the company";"income";;1
879;709100;709000;"- sur ventes de produits finis";"- On sales of finished products";"income";;1
880;709200;709000;"- sur ventes de produits intermédiaires ";"- On sales of intermediate products";"income";;1
881;709400;709000;"- sur travaux";"- Work on";"income";;1
882;709500;709000;"- sur études";"- Studies on";"income";;1
883;709600;709000;"- sur prestations de services";"- On services";"income";;1
884;709700;709000;"- sur ventes de marchandises";"- On sales of goods";"income";;1
885;709800;709000;"- sur produits des activités annexes";"- Revenue from ancillary activities on";"income";;1
886;71;"CL7";"Production stockée (ou déstockage)";"Stored production (or stocking)";"view";;1
887;713000;71;"Variation des stocks (en-cours de production, produits)";"Changes in inventories (in-progress, products)";"income";;1
888;713300;713000;"Variation des en-cours de production de biens";"Change in stocks of goods production";"income";;1
889;713310;713300;"Produits en cours";"Products in";"income";;1
890;713350;713300;"Travaux en cours";"Work in progress";"income";;1
891;713400;713000;"Variation des en-cours de production de services";"Change in stocks of service production";"income";;1
892;713410;713400;"Études en cours";"Ongoing Studies";"income";;1
893;713450;713400;"Prestations de services en cours";"Services being";"income";;1
894;713500;713000;"Variation des stocks de produits";"Change in product inventories";"income";;1
895;713510;713500;"Produits intermédiaires ";"Intermediates";"income";;1
896;713550;713500;"Produits finis";"Finished Products";"income";;1
897;713580;713500;"Produits résiduels";"Residual products";"income";;1
898;72;"CL7";"Production immobilisée";"Capitalised production";"view";;1
899;721000;72;"Immobilisations incorporelles ";"Intangible assets";"income";;1
900;722000;72;"Immobilisations corporelles";"Tangible assets";"income";;1
901;74;"CL7";"Subventions d'exploitation";"Operating subsidies";"view";;1
902;75;"CL7";"Autres produits de gestion courante";"Other products of daily management";"view";;1
903;751000;75;"Redevances pour concessions, brevets, licences, marques, procédés, logiciels, droits et valeurs similaires";"Fees for concessions, patents, licenses, trademarks, processes, software, similar rights and assets";"income";;1
904;751100;751000;"Redevances pour concessions, brevets, licences, marques, procédés, logiciels ";"Fees for concessions, patents, licenses, trademarks, processes, software";"income";;1
905;751600;751000;"Droits d'auteur et de reproduction";"Copyright and reproduction";"income";;1
906;751800;751000;"Autres droits et valeurs similaires";"Other similar rights and assets";"income";;1
907;752000;75;"Revenus des immeubles non affectés aux activités professionnelles";"Revenue from property not used for professional activities";"income";;1
908;753000;75;"Jetons de présence et rémunérations d'administrateurs, gérants...";"Fees and remuneration of directors, managers...";"income";;1
909;754000;75;"Ristournes perçues des coopératives (provenant des excédents)";"Levies collected from cooperatives (from surplus)";"income";;1
910;755000;75;"Quotes-parts de résultats sur opérations faites en commun";"Assessments of results from joint ventures";"income";;1
911;755100;755000;"Quote-part de perte transférée (comptabilité du gérant)";"Share of loss transferred (Accounting Manager)";"income";;1
912;755500;755000;"Quote-part de bénéfice attribuée (comptabilité des associés non-gérants)";"Share of profits allocated (accounting for non-managing)";"income";;1
913;758000;75;"Produits divers de gestion courante";"Miscellaneous current management";"income";;1
914;76;"CL7";"Produits financiers";"Financial Products";"view";;1
915;761000;76;"Produits de participations";"Income from investments";"income";;1
916;761100;761000;"Revenus des titres de participation";"Income on equity";"income";;1
917;761600;761000;"Revenus sur autres formes de participation ";"Income from other forms of participation";"income";;1
918;761700;761000;"Revenus des créances rattachées à des participations";"Income from debt to equity investments";"income";;1
919;762000;76;"Produits des autres immobilisations financières";"Income from other investments";"income";;1
920;762100;762000;"Revenus des titres immobilisés";"Fixed income securities";"income";;1
921;762600;762000;"Revenus des prêts";"Income from loans";"income";;1
922;762700;762000;"Revenus des créances immobilisées";"Revenue from long term receivables";"income";;1
923;763000;76;"Revenus des autres créances";"Revenues from other receivables";"income";;1
924;763100;763000;"Revenus des créances commerciales ";"Revenue from trade debtors";"income";;1
925;763800;763000;"Revenus des créances diverses";"Revenue from miscellaneous claims";"income";;1
926;764000;76;"Revenus des valeurs mobilières de placement";"Income from securities investment";"income";;1
927;765000;76;"Escomptes obtenus";"Discounts obtained";"income";;1
928;766000;76;"Gains de change";"Foreign exchange gains";"income";;1
929;767000;76;"Produits nets sur cessions de valeurs mobilières de placement";"Net gains on sales of marketable securities";"income";;1
930;768000;76;"Autres produits financiers";"Other financial";"income";;1
931;77;"CL7";"Produits exceptionnels";"Exceptional items";"view";;1
932;771000;77;"Produits exceptionnels sur opérations de gestion";"Extraordinary income on management operations";"income";;1
933;771100;771000;"Dédits et pénalités perçus sur achats et sur ventes";"Forfeits and penalties levied on purchases and sales";"income";;1
934;771300;771000;"Libéralités reçues";"Donations received";"income";;1
935;771400;771000;"Rentrées sur créances amorties";"Bad debt written off";"income";;1
936;771500;771000;"Subventions d'équilibre";"Matching grants";"income";;1
937;771700;771000;"Dégrèvements d'impôts autres qu'impôts sur les bénéfices";"Tax relief other than taxes on profits";"income";;1
938;771800;771000;"Autres produits exceptionnels sur opérations de gestion";"Other extraordinary income on management operations";"income";;1
939;772000;77;"Produits sur exercices antérieurs (en cours d'exercice seulement)";"Products in previous years (during the year only)";"income";;1
940;775000;77;"Produits des cessions d'éléments d'actif";"Proceeds from sale of assets";"income";;1
941;775100;775000;"Immobilisations incorporelles";"Intangible assets";"income";;1
942;775200;775000;"Immobilisations corporelles";"Tangible assets";"income";;1
943;775600;775000;"Immobilisations financières";"Financial assets";"income";;1
944;775800;775000;"Autres éléments d'actif";"Other assets";"income";;1
945;777000;77;"Quote-part des subventions d'investissement virée au résultat de l'exercice";"Share of investment grants transferred to income statement";"income";;1
946;778000;77;"Autres produits exceptionnels";"Other extraordinary income";"income";;1
947;778100;778000;"Bonis provenant de clauses d'indexation ";"Bonuses from indexation clauses";"income";;1
948;778200;778000;"Lots";"Lots";"income";;1
949;778300;778000;"Bonis provenant du rachat par l'entreprise d'actions et d'obligations émises par elle-même";"Bonuses from the repurchase by the Company of shares and bonds issued by itself";"income";;1
950;778800;778000;"Produits exceptionnels divers";"Exceptional income";"income";;1
951;78;"CL7";"Reprises sur amortissements, dépréciations et provisions";"Reversals of depreciation, amortization and provisions";"view";;1
952;781000;78;"Reprises sur amortissements, dépréciations et provisions (à inscrire dans les produits d'exploitation)";"Reversals of depreciation, amortization and provisions (to be included in revenue)";"income";;1
953;781100;781000;"Reprises sur amortissements des immobilisations incorporelles et corporelles ";"Reversal of amortization of intangible and tangible";"income";;1
954;781110;781100;"Immobilisations incorporelles";"Intangible assets";"income";;1
955;781120;781100;"Immobilisations corporelles";"Tangible assets";"income";;1
956;781500;781000;"Reprises sur provisions d'exploitation";"Reversals of operating provisions";"income";;1
957;781600;781000;"Reprises sur dépréciations des immobilisations corporelles et incorporelles";"Reversals of impairment of tangible and intangible";"income";;1
958;781610;781600;"Immobilisations incorporelles";"Intangible assets";"income";;1
959;781620;781600;"Immobilisations corporelles";"Tangible assets";"income";;1
960;781700;781000;"Reprises sur dépréciations des actifs circulants";"Reversals of impairment of assets";"income";;1
961;781730;781700;"Stocks et en-cours";"Stocks and work in progress";"income";;1
962;781740;781700;"Créances";"Claims";"income";;1
963;786000;78;"Reprises sur dépréciations et provisions (à inscrire dans les produits financiers)";"Reversals of impairment losses and provisions (to be included in financial income)";"income";;1
964;786500;786000;"Reprises sur provisions financiers";"Financial Provision reversals";"income";;1
965;786600;786000;"Reprises sur dépréciations des éléments financiers";"Reversals of impairment losses on financial items";"income";;1
966;786620;786600;"Immobilisations financières";"Financial assets";"income";;1
967;786650;786600;"Valeurs mobilières de placement";"Marketable securities";"income";;1
968;787000;78;"Reprises sur dépréciations et provisions (à inscrire dans les produits exceptionnels)";"Reversals of impairment losses and provisions (the register in extraordinary income)";"income";;1
969;787200;787000;"Reprises sur provisions réglementées (immobilisations)";"Reversal of regulated provisions (capital)";"income";;1
970;787250;787200;"Amortissements dérogatoires";"Depreciation allowances";"income";;1
971;787260;787200;"Provision spéciale de réévaluation";"Special revaluation reserve";"income";;1
972;787270;787200;"Plus-values réinvesties";"Capital gains reinvested";"income";;1
973;787300;787000;"Reprises sur provisions réglementées (stocks) ";"Reversals of provisions regulated (stocks)";"income";;1
974;787400;787000;"Reprises sur autres provisions réglementées ";"Reversal of other provisions regulated";"income";;1
975;787500;787000;"Reprises sur provisions exceptionnelles";"Reversals of provisions for exceptional";"income";;1
976;787600;787000;"Reprises pour dépréciations exceptionnelles";"Reversals of impairment losses for";"income";;1
977;79;"CL7";"Transferts de charges";"Expense transfers";"view";;1
978;791000;79;"Transferts de charges d'exploitation";"Transfers of operating expenses";"income";;1
979;796000;79;"Transferts de charges financières";"Transfers of financial charges";"income";;1
980;797000;79;"Transferts de charges exceptionnelles";"Transfers exceptional costs";"income";;1
981;80;"CL8";"Engagements";"Commitments";"view";;1
982;801000;80;"Engagements donnés par l'entité";"Commitments made by the entity";"commitment";;1
983;801100;801000;"Avals, cautions, garanties";"Endorsements, guarantees";"commitment";;1
984;801400;801000;"Effets circulant sous l'endos de l'entité";"Effects flowing in the back of the entity";"commitment";;1
985;801600;801000;"Redevances crédit-bail restant à courir";"Leasing charges remaining";"commitment";;1
986;801610;801600;"Crédit-bail mobilier";"Equipment leasing";"commitment";;1
987;801650;801600;"Crédit-bail immobilier";"Property leasing";"commitment";;1
988;801800;801000;"Autres engagements donnés";"Other commitments";"commitment";;1
989;802000;80;"Engagements reçus par l'entité";"Commitments received by the entity";"commitment";;1
990;802100;802000;"Avals, cautions, garanties";"Endorsements, guarantees";"commitment";;1
991;802400;802000;"Créances escomptées non échues";"Unmatured claims expected";"commitment";;1
992;802600;802000;"Engagements reçus pour utilisation en crédit-bail";"Commitments received for use in leasing";"commitment";;1
993;802610;802600;"Crédit-bail mobilier";"Equipment leasing";"commitment";;1
994;802650;802600;"Crédit-bail immobilier";"Property leasing";"commitment";;1
995;802800;802000;"Autres engagements reçus";"Other commitments received";"commitment";;1
996;809;80;"Contrepartie des engagements";"For commitments";"view";;1
997;809100;809000;"Contrepartie 801";"Consideration 801";"commitment";;1
998;809200;809000;"Contrepartie 802";"Consideration 802";"commitment";;1
999;88;"CL8";"Résultats en instance d'affectation";"Results pending allocation";"view";;1
1000;89;"CL8";"Bilan";"Balance Sheet";"view";;1
1001;890000;89;"Bilan d'ouverture";"Opening balance";"special";;1
1002;891000;89;"Bilan de clôture";"Closing balance";"special";;1
